amber = "Amber"
cattle = "Cattle"
cavorite = "Cavorite"
clothing = "Clothing"
coal = "Coal"
coffee = "Coffee"
copper = "Copper"
cotton = "Cotton"
fabric = "Fabric"
fish = "Fish"
fruit = "Fruit"
furniture = "Furniture"
glass = "Glass"
gold = "Gold"
gold_ore = "Gold Ore"
grain = "Grain"
horses = "Horses"
iron = "Iron"
iron_ore = "Iron Ore"
leather = "Leather"
lumber = "Lumber"
paper = "Paper"
refined_sugar = "Refined Sugar"
salt = "Salt"
silk = "Silk"
silver = "Silver"
stone = "Stone"
sugar_cane = "Sugar Cane"
timber = "Timber"
tools = "Tools"
wine = "Wine"
wool = "Wool"
