alborz = "Alborz"
ardebil = "Ardebil"
bushehr = "Bushehr"
chahar_mahall = "Chahar Mahall"
east_azarbaijan = "East Azarbaijan"
fars = "Fars"
gilan = "Gilan"
golestan = "Golestan"
hamadan = "Hamadan"
hormozgan = "Hormozgan"
ilam = "Ilam"
isfahan = "Isfahan"
isfahan_persian = "Esfahan"
kerman = "Kerman"
kermanshah = "Kermanshah"
c_khuzestan = "Khuzestan"
kohgiluyeh = "Kohgiluyeh"
kordestan = "Kordestan"
lorestan = "Lorestan"
markazi = "Markazi"
mazandaran = "Mazandaran"
north_khorasan = "North Khorasan"
qazvin = "Qazvin"
qom = "Qom"
razavi_khorasan = "Razavi Khorasan"
semnan = "Semnan"
sistan = "Sistan"
south_khorasan = "South Khorasan"
teheran = "Teheran"
teheran_persian = "Tehran"
west_azarbaijan = "West Azarbaijan"
yazd = "Yazd"
zanjan = "Zanjan"
