anhui = "Anhui"
beijing = "Beijing"
chongqing = "Chongqing"
fujian = "Fujian"
gansu = "Gansu"
guangdong = "Guangdong"
guangxi = "Guangxi"
guizhou = "Guizhou"
hainan = "Hainan"
hebei = "Hebei"
henan = "Henan"
hubei = "Hubei"
hunan = "Hunan"
inner_mongolia = "Inner Mongolia"
jiangsu = "Jiangsu"
jiangxi = "Jiangxi"
jilin = "Jilin"
liaoning = "Liaoning"
ningxia = "Ningxia"
qinghai = "Qinghai"
shaanxi = "Shaanxi"
shandong = "Shandong"
shanxi = "Shanxi"
sichuan = "Sichuan"
tianjin = "Tianjin"
tibet = "Tibet"
tibet_chinese = "Xizang"
xinjiang = "Xinjiang"
yunnan = "Yunnan"
zhejiang = "Zhejiang"
