c_adana = "Adana"
adiyaman = "Adiyaman"
afyonkarahisar = "Afyonkarahisar"
agri = "Agri"
aksaray = "Aksaray"
amasya = "Amasya"
c_amida = "Amida"
c_amida_turkish = "Diyarbakir"
ankara = "Ankara"
c_antalya = "Antalya"
ardahan = "Ardahan"
artvin = "Artvin"
c_aydin = "Aydin"
balikesir = "Balikesir"
bartin = "Bartin"
batman = "Batman"
bayburt = "Bayburt"
bilecik = "Bilecik"
bingol = "Bingöl"
bitlis = "Bitlis"
bolu = "Bolu"
burdur = "Burdur"
c_bursa = "Bursa"
cankiri = "Çankiri"
corum = "Çorum"
denizli = "Denizli"
duzce = "Düzce"
elazig = "Elazig"
erzincan = "Erzincan"
erzurum = "Erzurum"
eskisehir = "Eskisehir"
c_gaziantep = "Gaziantep"
giresun = "Giresun"
gumushane = "Gümüshane"
hakkari = "Hakkari"
isparta = "Isparta"
kahramanmaras = "Kahramanmaras"
karabuk = "Karabük"
karaman = "Karaman"
kars = "Kars"
kastamonu = "Kastamonu"
kayseri = "Kayseri"
kinkkale = "Kinkkale"
kirsehir = "Kirsehir"
kutahya = "Kütahya"
c_kocaeli = "Kocaeli"
konya = "Konya"
malatya = "Malatya"
manisa = "Manisa"
mardin = "Mardin"
mersin = "Mersin"
mugla = "Mugla"
mus = "Mus"
nevsehir = "Nevsehir"
nigde = "Nigde"
ordu = "Ordu"
osmaniye = "Osmaniye"
rize = "Rize"
sakarya = "Sakarya"
samsun = "Samsun"
sanliurfa = "Sanliurfa"
siirt = "Siirt"
sinope = "Sinope"
sinope_turkish = "Sinop"
sirnak = "Sirnak"
sivas = "Sivas"
c_smyrna = "Smyrna"
c_smyrna_turkish = "Izmir"
tokat = "Tokat"
trebizond = "Trebizond"
trebizond_turkish = "Trabzon"
c_troad = "Troad"
c_troad_turkish = "Çanakkale"
tunceli = "Tunceli"
usak = "Usak"
van = "Van"
yozgat = "Yozgat"
zinguldak = "Zinguldak"
