alsatian = "Alsatian"
arabic = "Arabic"
aramaic = "Aramaic"
assyrian = "Assyrian"
austrian = "Austrian"
babylonian = "Babylonian"
basque = "Basque"
bavarian = "Bavarian"
brazilian = "Brazilian"
byelorussian = "Byelorussian"
bulgarian = "Bulgarian"
castillian = "Castillian"
croatian = "Croatian"
czech = "Czech"
danish = "Danish"
dutch = "Dutch"
egyptian = "Egyptian"
english = "English"
flemish = "Flemish"
franconian = "Franconian"
french = "French"
greek = "Greek"
hebrew = "Hebrew"
hittite = "Hittite"
hungarian = "Hungarian"
italian = "Italian"
lithuanian = "Lithuanian"
lowland_scottish = "Lowland Scottish"
persian = "Persian"
phoenician = "Phoenician"
polish = "Polish"
portuguese = "Portuguese"
rhenish = "Rhenish"
romanian = "Romanian"
russian = "Russian"
saxon = "Saxon"
serbian = "Serbian"
slovak = "Slovak"
slovene = "Slovene"
swabian = "Swabian"
swedish = "Swedish"
thuringian = "Thuringian"
tupi = "Tupi"
turkish = "Turkish"
ukrainian = "Ukrainian"
walloon = "Walloon"
