amsterdam = "Amsterdam"
antwerp = "Antwerp"
athens = "Athens"
breslau = "Breslau"
byzantium = "Byzantium"
byzantium_christian = "Constantinople"
byzantium_turkish = "Istanbul"
copenhagen = "Copenhagen"
damascus = "Damascus"
danzig = "Danzig"
edinburgh = "Edinburgh"
genoa = "Genoa"
hamburg = "Hamburg"
krakow = "Krakow"
lemberg = "Lemberg"
lisbon = "Lisbon"
london = "London"
lubeck = "LÃ¼beck"
paris = "Paris"
pest = "Pest"
prague = "Prague"
rio_de_janeiro = "Rio de Janeiro"
rome = "Rome"
seville = "Seville"
trieste = "Trieste"
tyre = "Tyre"
tyre_arabic = "Sidon"
venice = "Venice"
vienna = "Vienna"
warsaw = "Warsaw"
