archers = "Archers"
armor = "Armor"
arquebusiers = "Arquebusiers"
calivermen = "Calivermen"
camel_cavalry = "Camel Cavalry"
carbineers = "Carbineers"
clubmen = "Clubmen"
conscripts = "Conscripts"
cossacks = "Cossacks"
crossbowmen = "Crossbowmen"
cuirassiers = "Cuirassiers"
culverin = "Culverin"
field_artillery = "Field Artillery"
grenadiers = "Grenadiers"
guards = "Guards"
halberdiers = "Halberdiers"
harquebusiers = "Harquebusiers"
horse_archers = "Horse Archers"
horse_artillery = "Horse Artillery"
hussars = "Hussars"
infantry = "Infantry"
knights = "Knights"
lancers = "Lancers"
longbowmen = "Longbowmen"
machine_gunners = "Machine Gunners"
mobile_artillery = "Mobile Artillery"
musketeers = "Musketeers"
pikemen = "Pikemen"
railroad_guns = "Railroad Guns"
rangers = "Rangers"
regulars = "Regulars"
rifle_infantry = "Rifle Infantry"
royal_artillery = "Royal Artillery"
saboteurs = "Saboteurs"
sappers = "Sappers"
scouts = "Scouts"
sharpshooters = "Sharpshooters"
siege_artillery = "Field Artillery"
skirmishers = "Skirmishers"
spearmen = "Spearmen"
squires = "Squires"
war_elephants = "War Elephants"
